+--+--+--+--+--+--+--+--+--+--+--+--+--+--+--+--+
            |           |     |     |     |     |
+--+--+--+  +  +--+--+  +  +  +  +  +  +  +  +  +
|           |  |     |     |     |     |     |  |
+  +--+--+--+  +  +  +--+--+--+--+--+--+--+--+  +
|  |        |  |  |           |                 |
+  +--+--+  +  +--+--+--+--+  +  +  +--+--+--+--+
|     |     |        |     |     |     |        |
+--+  +  +--+--+--+  +  +--+--+--+--+  +  +--+--+
|        |           |     |        |  |        |
+  +--+--+  +--+--+--+  +  +--+--+  +  +--+--+  +
|        |     |        |  |        |        |  |
+--+--+  +--+  +  +--+--+  +  +--+--+--+--+  +  +
|     |  |     |        |           |        |  |
+--+  +  +  +--+--+--+  +--+--+--+  +  +--+  +  +
|     |  |  |           |     |        |     |  |
+  +--+  +  +  +--+--+--+  +  +  +--+--+  +--+  +
|           |  |        |  |  |        |  |     |
+--+--+  +--+  +--+--+  +  +  +--+--+--+  +  +--+
|        |     |        |  |              |  |  |
+  +--+--+  +  +  +--+--+  +--+--+--+--+--+  +  +
|  |     |  |     |     |        |  |        |  |
+--+  +  +  +--+--+  +--+--+--+  +  +  +--+--+  +
|     |  |        |        |     |     |     |  |
+  +--+  +--+--+  +--+--+  +  +--+  +--+  +  +  +
|     |     |  |  |     |  |           |  |  |  |
+--+  +--+  +  +  +  +  +  +--+--+  +  +  +  +  +
|     |  |  |     |  |  |     |     |     |  |  |
+  +--+  +  +--+--+  +  +  +  +  +--+--+--+  +  +
|  |     |           |  |  |  |        |  |     |
+  +  +--+  +--+  +--+  +  +--+--+  +  +  +--+  +
|     |     |     |                 |     |      
+--+--+--+--+--+--+--+--+--+--+--+--+--+--+--+--+

