+--+--+--+--+--+--+--+--+
|B          |     |S    |
+  +--+--+--+  +  +--+  +
|  |     |     |     |  |
+  +  +  +  +--+  +  +  +
|  |  |  |  |     |     |
+  +  +  +  +  +--+--+--+
|  |  |  |  |  |     |  |
+  +  +  +  +  +  +  +  +
|     |     |     |     |
+--+--+--+--+--+--+  +  +
|                    |  |
+  +--+--+--+--+--+--+  +
|     |D    |           |
+--+  +--+  +  +--+--+--+
|           |  $      E |
+--+--+--+--+--+--+--+--+
